110111011110000-
010101010010000-
010101010010000-
010101010010000-
010101010010000-
010101010010000-
011101110011100-
000000000000000