110111011110000-
010101010010000-
010101010010000-
010101010010000-
010101010010000-
010101010010000-
011101110011133-
000000000000033