11011101111000000-
01010101001000000-
01010101001000000-
01010101001000000-
01010101001000000-
01010101001000000-
01110111001113300-
00000000000003300-
00000000000000000